###############
##           ##
##           ##
##           ##
##  e P      ##
##           ##
##           ##
##           ##
##           ##
##           ##
##           ##
##           ##
##           ##
##           ##
###############
