#############################
##                         ##
##  # # # # # # # # # # #  ##
##                         ##
##  # # # # # # # # # # #t ##
##                         ##
##  # # # # # # # # # # #  ##
## P                       ##
##  # # # # # # # # # # #  ##
##                         ##
##T # # # # # # # # # # #  ##
##                         ##
##  # # # # # # # # # # #e ##
##                         ##
##  # # # # # # # # # # #  ##
##                         ##
##  # # # # # # # # # # #  ##
##                         ##
#############################